333333333333333
3     1       3
311  11111    3
3    2        3
3        2    3
3     2222    3
3  2          3
3  5555  555553
3     5       3
333333333333333