333333333333333
3     1       3
3             3
3    2        3
3        2    3
3             3
3  2          3
3     5      53
3     5       3
333333333333333